../encode_uw_dhs_lsgkm/macs_files/wgEncodeUwDnaseAoafAlnRep1_summits.bed	fibroblast	aortic adventitial
../encode_uw_dhs_lsgkm/macs_files/wgEncodeUwDnaseAoafAlnRep2_summits.bed	fibroblast	aortic adventitial
../encode_uw_dhs_lsgkm/macs_files/wgEncodeUwDnaseHbmecAlnRep1_summits.bed	microvascular endothelial cells	brain
../encode_uw_dhs_lsgkm/macs_files/wgEncodeUwDnaseHbmecAlnRep2_summits.bed	microvascular endothelial cells	brain
../encode_uw_dhs_lsgkm/macs_files/wgEncodeUwDnaseHbvpAlnRep1_summits.bed	smooth muscle cells	brain
../encode_uw_dhs_lsgkm/macs_files/wgEncodeUwDnaseHbvsmcAlnRep1_summits.bed	smooth muscle cells	brain
../encode_uw_dhs_lsgkm/macs_files/wgEncodeUwDnaseHbvsmcAlnRep2_summits.bed	smooth muscle cells	brain
../encode_uw_dhs_lsgkm/macs_files/wgEncodeUwDnaseHcfaaAlnRep1_summits.bed	fibroblast	cardiac
../encode_uw_dhs_lsgkm/macs_files/wgEncodeUwDnaseHcfaaAlnRep2_summits.bed	fibroblast	cardiac
../encode_uw_dhs_lsgkm/macs_files/wgEncodeUwDnaseHcfAlnRep1_summits.bed	fibroblast	cardiac
../encode_uw_dhs_lsgkm/macs_files/wgEncodeUwDnaseHcfAlnRep2_summits.bed	fibroblast	cardiac
../encode_uw_dhs_lsgkm/macs_files/wgEncodeUwDnaseHcmAlnRep1_summits.bed	myocyte	cardiac
../encode_uw_dhs_lsgkm/macs_files/wgEncodeUwDnaseHcmAlnRep2_summits.bed	myocyte	cardiac
../encode_uw_dhs_lsgkm/macs_files/wgEncodeUwDnaseHmvecdadAlnRep1_summits.bed	microvascular endothelial cells	skin
../encode_uw_dhs_lsgkm/macs_files/wgEncodeUwDnaseHmvecdadAlnRep2_summits.bed	microvascular endothelial cells	skin
../encode_uw_dhs_lsgkm/macs_files/wgEncodeUwDnaseHmvecdbladAlnRep1_summits.bed	microvascular endothelial cells	skin
../encode_uw_dhs_lsgkm/macs_files/wgEncodeUwDnaseHmvecdbladAlnRep2_summits.bed	microvascular endothelial cells	skin
../encode_uw_dhs_lsgkm/macs_files/wgEncodeUwDnaseHmvecdblneoAlnRep1_summits.bed	microvascular endothelial cells	skin
../encode_uw_dhs_lsgkm/macs_files/wgEncodeUwDnaseHmvecdblneoAlnRep2_summits.bed	microvascular endothelial cells	skin
../encode_uw_dhs_lsgkm/macs_files/wgEncodeUwDnaseHmvecdlyadAlnRep1_summits.bed	microvascular endothelial cells	skin
../encode_uw_dhs_lsgkm/macs_files/wgEncodeUwDnaseHmvecdlyadAlnRep2_summits.bed	microvascular endothelial cells	skin
../encode_uw_dhs_lsgkm/macs_files/wgEncodeUwDnaseHmvecdlyneoAlnRep1_summits.bed	microvascular endothelial cells	skin
../encode_uw_dhs_lsgkm/macs_files/wgEncodeUwDnaseHmvecdlyneoAlnRep2_summits.bed	microvascular endothelial cells	skin
../encode_uw_dhs_lsgkm/macs_files/wgEncodeUwDnaseHmvecdneoAlnRep1_summits.bed	microvascular endothelial cells	skin
../encode_uw_dhs_lsgkm/macs_files/wgEncodeUwDnaseHmvecdneoAlnRep2_summits.bed	microvascular endothelial cells	skin
../encode_uw_dhs_lsgkm/macs_files/wgEncodeUwDnaseHmveclblAlnRep1_summits.bed	microvascular endothelial cells	lung
../encode_uw_dhs_lsgkm/macs_files/wgEncodeUwDnaseHmveclblAlnRep2_summits.bed	microvascular endothelial cells	lung
../encode_uw_dhs_lsgkm/macs_files/wgEncodeUwDnaseHmvecllyAlnRep1_summits.bed	microvascular endothelial cells	lung
../encode_uw_dhs_lsgkm/macs_files/wgEncodeUwDnaseHmvecllyAlnRep2_summits.bed	microvascular endothelial cells	lung
../encode_uw_dhs_lsgkm/macs_files/wgEncodeUwDnaseHpaecAlnRep1_summits.bed	artery endothelial cells	blood vessel
../encode_uw_dhs_lsgkm/macs_files/wgEncodeUwDnaseHpafAlnRep1_summits.bed	fibroblast	blood vessel
../encode_uw_dhs_lsgkm/macs_files/wgEncodeUwDnaseHpafAlnRep2_summits.bed	fibroblast	blood vessel
../encode_uw_dhs_lsgkm/macs_files/wgEncodeUwDnaseHsmmAlnRep1_summits.bed	myoblast	skeletal muscle
../encode_uw_dhs_lsgkm/macs_files/wgEncodeUwDnaseHsmmAlnRep2_summits.bed	myoblast	skeletal muscle
../encode_uw_dhs_lsgkm/macs_files/wgEncodeUwDnaseHsmmtAlnRep1_summits.bed	myoblast	skeletal muscle
../encode_uw_dhs_lsgkm/macs_files/wgEncodeUwDnaseHsmmtAlnRep2_summits.bed	myoblast	skeletal muscle
../encode_uw_dhs_lsgkm/macs_files/wgEncodeUwDnaseHuvecAlnRep1_summits.bed	vein endothelial cells	umbilical
../encode_uw_dhs_lsgkm/macs_files/wgEncodeUwDnaseHuvecAlnRep2_summits.bed	vein endothelial cells	umbilical
../encode_uw_dhs_lsgkm/macs_files/wgEncodeUwDnaseLhcnm2AlnRep1_summits.bed	myoblast	skeletal muscle
../encode_uw_dhs_lsgkm/macs_files/wgEncodeUwDnaseLhcnm2AlnRep2_summits.bed	myoblast	skeletal muscle
../encode_uw_dhs_lsgkm/macs_files/wgEncodeUwDnaseLhcnm2Diff4dAlnRep1_summits.bed	myoblast	skeletal muscle
../encode_uw_dhs_lsgkm/macs_files/wgEncodeUwDnaseLhcnm2Diff4dAlnRep2_summits.bed	myoblast	skeletal muscle
../encode_uw_dhs_lsgkm/macs_files/wgEncodeUwDnaseSkmcAlnRep1_summits.bed	myosatellite cells	skeletal muscle
../encode_uw_dhs_lsgkm/macs_files/wgEncodeUwDnaseSkmcAlnRep2_summits.bed	myosatellite cells	skeletal muscle
../encode_duke_dhs_lsgkm/macs_files/wgEncodeOpenChromDnaseAosmcSerumfreeAlnRep1_summits.bed	smooth muscle cells	aortic
../encode_duke_dhs_lsgkm/macs_files/wgEncodeOpenChromDnaseAosmcSerumfreeAlnRep2_summits.bed	smooth muscle cells	aortic
../encode_duke_dhs_lsgkm/macs_files/wgEncodeOpenChromDnaseHsmmAlnRep1_summits.bed	myoblast	skeletal muscle
../encode_duke_dhs_lsgkm/macs_files/wgEncodeOpenChromDnaseHsmmAlnRep2_summits.bed	myoblast	skeletal muscle
../encode_duke_dhs_lsgkm/macs_files/wgEncodeOpenChromDnaseHsmmAlnRep3_summits.bed	myoblast	skeletal muscle
../encode_duke_dhs_lsgkm/macs_files/wgEncodeOpenChromDnaseHsmmembAlnRep1_summits.bed	myoblast	skeletal muscle
../encode_duke_dhs_lsgkm/macs_files/wgEncodeOpenChromDnaseHsmmembAlnRep2_summits.bed	myoblast	skeletal muscle
../encode_duke_dhs_lsgkm/macs_files/wgEncodeOpenChromDnaseHsmmfshdAlnRep1_summits.bed	myoblast	skeletal muscle
../encode_duke_dhs_lsgkm/macs_files/wgEncodeOpenChromDnaseHsmmfshdAlnRep2_summits.bed	myoblast	skeletal muscle
../encode_duke_dhs_lsgkm/macs_files/wgEncodeOpenChromDnaseHsmmfshdAlnRep3_summits.bed	myoblast	skeletal muscle
../encode_duke_dhs_lsgkm/macs_files/wgEncodeOpenChromDnaseHsmmtAlnRep1_summits.bed	myoblast	skeletal muscle
../encode_duke_dhs_lsgkm/macs_files/wgEncodeOpenChromDnaseHsmmtAlnRep2_summits.bed	myoblast	skeletal muscle
../encode_duke_dhs_lsgkm/macs_files/wgEncodeOpenChromDnaseHsmmtAlnRep3_summits.bed	myoblast	skeletal muscle
../encode_duke_dhs_lsgkm/macs_files/wgEncodeOpenChromDnaseHuvecAlnRep1_summits.bed	vein endothelial cells	umbilical
../encode_duke_dhs_lsgkm/macs_files/wgEncodeOpenChromDnaseHuvecAlnRep2_summits.bed	vein endothelial cells	umbilical
../encode_duke_dhs_lsgkm/macs_files/wgEncodeOpenChromDnasePsoasmuscleocAlnRep1_summits.bed	muscle	psoas
../encode_duke_dhs_lsgkm/macs_files/wgEncodeOpenChromDnasePsoasmuscleocAlnRep2_summits.bed	muscle	psoas
../roadmap_uw_dhs_lsgkm/macs_files/UW.Fetal_Muscle_Arm.ChromatinAccessibility.H-23808.DS17432_summits.bed	muscle	fetal
../roadmap_uw_dhs_lsgkm/macs_files/UW.Fetal_Muscle_Arm.ChromatinAccessibility.H-23914.DS17765_summits.bed	muscle	fetal
../roadmap_uw_dhs_lsgkm/macs_files/UW.Fetal_Muscle_Arm.ChromatinAccessibility.H-23941.DS17825_summits.bed	muscle	fetal
../roadmap_uw_dhs_lsgkm/macs_files/UW.Fetal_Muscle_Arm.ChromatinAccessibility.H-23964.DS17848_summits.bed	muscle	fetal
../roadmap_uw_dhs_lsgkm/macs_files/UW.Fetal_Muscle_Arm.ChromatinAccessibility.H-24005.DS18080_summits.bed	muscle	fetal
../roadmap_uw_dhs_lsgkm/macs_files/UW.Fetal_Muscle_Arm.ChromatinAccessibility.H-24042.DS18176_summits.bed	muscle	fetal
../roadmap_uw_dhs_lsgkm/macs_files/UW.Fetal_Muscle_Arm.ChromatinAccessibility.H-24078.DS18379_summits.bed	muscle	fetal
../roadmap_uw_dhs_lsgkm/macs_files/UW.Fetal_Muscle_Arm.ChromatinAccessibility.H-24089.DS18452_summits.bed	muscle	fetal
../roadmap_uw_dhs_lsgkm/macs_files/UW.Fetal_Muscle_Arm.ChromatinAccessibility.H-24111.DS18473_summits.bed	muscle	fetal
../roadmap_uw_dhs_lsgkm/macs_files/UW.Fetal_Muscle_Arm.ChromatinAccessibility.H-24125.DS18559_summits.bed	muscle	fetal
../roadmap_uw_dhs_lsgkm/macs_files/UW.Fetal_Muscle_Arm.ChromatinAccessibility.H-24143.DS18992_summits.bed	muscle	fetal
../roadmap_uw_dhs_lsgkm/macs_files/UW.Fetal_Muscle_Arm.ChromatinAccessibility.H-24198.DS19051_summits.bed	muscle	fetal
../roadmap_uw_dhs_lsgkm/macs_files/UW.Fetal_Muscle_Arm.ChromatinAccessibility.H-24218.DS19053_summits.bed	muscle	fetal
../roadmap_uw_dhs_lsgkm/macs_files/UW.Fetal_Muscle_Arm.ChromatinAccessibility.H-24244.DS19270_summits.bed	muscle	fetal
../roadmap_uw_dhs_lsgkm/macs_files/UW.Fetal_Muscle_Arm.ChromatinAccessibility.H-24259.DS19295_summits.bed	muscle	fetal
../roadmap_uw_dhs_lsgkm/macs_files/UW.Fetal_Muscle_Arm.ChromatinAccessibility.H-24272.DS19380_summits.bed	muscle	fetal
../roadmap_uw_dhs_lsgkm/macs_files/UW.Fetal_Muscle_Arm.ChromatinAccessibility.H-24279.DS19439_summits.bed	muscle	fetal
../roadmap_uw_dhs_lsgkm/macs_files/UW.Fetal_Muscle_Arm.ChromatinAccessibility.H-24297.DS19646_summits.bed	muscle	fetal
../roadmap_uw_dhs_lsgkm/macs_files/UW.Fetal_Muscle_Back.ChromatinAccessibility.H-23914.DS17767_summits.bed	muscle	fetal
../roadmap_uw_dhs_lsgkm/macs_files/UW.Fetal_Muscle_Back.ChromatinAccessibility.H-23964.DS17850_summits.bed	muscle	fetal
../roadmap_uw_dhs_lsgkm/macs_files/UW.Fetal_Muscle_Back.ChromatinAccessibility.H-24005.DS18083_summits.bed	muscle	fetal
../roadmap_uw_dhs_lsgkm/macs_files/UW.Fetal_Muscle_Back.ChromatinAccessibility.H-24078.DS18377_summits.bed	muscle	fetal
../roadmap_uw_dhs_lsgkm/macs_files/UW.Fetal_Muscle_Back.ChromatinAccessibility.H-24089.DS18454_summits.bed	muscle	fetal
../roadmap_uw_dhs_lsgkm/macs_files/UW.Fetal_Muscle_Back.ChromatinAccessibility.H-24111.DS18468_summits.bed	muscle	fetal
../roadmap_uw_dhs_lsgkm/macs_files/UW.Fetal_Muscle_Back.ChromatinAccessibility.H-24143.DS18842_summits.bed	muscle	fetal
../roadmap_uw_dhs_lsgkm/macs_files/UW.Fetal_Muscle_Back.ChromatinAccessibility.H-24218.DS19117_summits.bed	muscle	fetal
../roadmap_uw_dhs_lsgkm/macs_files/UW.Fetal_Muscle_Back.ChromatinAccessibility.H-24244.DS19283_summits.bed	muscle	fetal
../roadmap_uw_dhs_lsgkm/macs_files/UW.Fetal_Muscle_Back.ChromatinAccessibility.H-24272.DS19384_summits.bed	muscle	fetal
../roadmap_uw_dhs_lsgkm/macs_files/UW.Fetal_Muscle_Back.ChromatinAccessibility.H-24279.DS19441_summits.bed	muscle	fetal
../roadmap_uw_dhs_lsgkm/macs_files/UW.Fetal_Muscle_Back.ChromatinAccessibility.H-24297.DS19648_summits.bed	muscle	fetal
../roadmap_uw_dhs_lsgkm/macs_files/UW.Fetal_Muscle_Back.ChromatinAccessibility.H-24409.DS20244_summits.bed	muscle	fetal
../roadmap_uw_dhs_lsgkm/macs_files/UW.Fetal_Muscle_Back.ChromatinAccessibility.H-24510.DNase.DS20789_summits.bed	muscle	fetal
../roadmap_uw_dhs_lsgkm/macs_files/UW.Fetal_Muscle_Back.ChromatinAccessibility.H-24595.DNase.DS21048_summits.bed	muscle	fetal
../roadmap_uw_dhs_lsgkm/macs_files/UW.Fetal_Muscle_Leg.ChromatinAccessibility.H-23808.DS17429_summits.bed	muscle	fetal
../roadmap_uw_dhs_lsgkm/macs_files/UW.Fetal_Muscle_Leg.ChromatinAccessibility.H-24078.DS18386_summits.bed	muscle	fetal
../roadmap_uw_dhs_lsgkm/macs_files/UW.Fetal_Muscle_Leg.ChromatinAccessibility.H-24089.DS18456_summits.bed	muscle	fetal
../roadmap_uw_dhs_lsgkm/macs_files/UW.Fetal_Muscle_Leg.ChromatinAccessibility.H-24111.DS18471_summits.bed	muscle	fetal
../roadmap_uw_dhs_lsgkm/macs_files/UW.Fetal_Muscle_Leg.ChromatinAccessibility.H-24143.DS18844_summits.bed	muscle	fetal
../roadmap_uw_dhs_lsgkm/macs_files/UW.Fetal_Muscle_Leg.ChromatinAccessibility.H-24198.DS19158_summits.bed	muscle	fetal
../roadmap_uw_dhs_lsgkm/macs_files/UW.Fetal_Muscle_Leg.ChromatinAccessibility.H-24218.DS19115_summits.bed	muscle	fetal
../roadmap_uw_dhs_lsgkm/macs_files/UW.Fetal_Muscle_Leg.ChromatinAccessibility.H-24244.DS19272_summits.bed	muscle	fetal
../roadmap_uw_dhs_lsgkm/macs_files/UW.Fetal_Muscle_Leg.ChromatinAccessibility.H-24259.DS19291_summits.bed	muscle	fetal
../roadmap_uw_dhs_lsgkm/macs_files/UW.Fetal_Muscle_Leg.ChromatinAccessibility.H-24272.DNase.DS19382_summits.bed	muscle	fetal
../roadmap_uw_dhs_lsgkm/macs_files/UW.Fetal_Muscle_Leg.ChromatinAccessibility.H-24279.DS19436_summits.bed	muscle	fetal
../roadmap_uw_dhs_lsgkm/macs_files/UW.Fetal_Muscle_Leg.ChromatinAccessibility.H-24297.DS19643_summits.bed	muscle	fetal
../roadmap_uw_dhs_lsgkm/macs_files/UW.Fetal_Muscle_Leg.ChromatinAccessibility.H-24409.DS20239_summits.bed	muscle	fetal
../roadmap_uw_dhs_lsgkm/macs_files/UW.Fetal_Muscle_Leg.ChromatinAccessibility.H-24510.DNase.DS20797_summits.bed	muscle	fetal
../roadmap_uw_dhs_lsgkm/macs_files/UW.Fetal_Muscle_Lower_Limb_Skeletal.ChromatinAccessibility.H-24042.DS18174_summits.bed	muscle	fetal
../roadmap_uw_dhs_lsgkm/macs_files/UW.Fetal_Muscle_Trunk.ChromatinAccessibility.H-23941.DS17827_summits.bed	muscle	fetal
../roadmap_uw_dhs_lsgkm/macs_files/UW.Fetal_Muscle_Trunk.ChromatinAccessibility.H-24409.DS20242_summits.bed	muscle	fetal
../roadmap_uw_dhs_lsgkm/macs_files/UW.Fetal_Muscle_Trunk.ChromatinAccessibility.H-24507.DS20544_summits.bed	muscle	fetal
../roadmap_uw_dhs_lsgkm/macs_files/UW.Fetal_Muscle_Upper_Limb_Skeletal.ChromatinAccessibility.H-23887.DS17661_summits.bed	muscle	fetal
../roadmap_uw_dhs_lsgkm/macs_files/UW.Fetal_Muscle_Upper_Trunk.ChromatinAccessibility.H-23887.DS17664_summits.bed	muscle	fetal
../roadmap_uw_dhs_lsgkm/macs_files/UW.Psoas_Muscle.ChromatinAccessibility.STL001.DNase.DS20325_summits.bed	muscle	fetal
../roadmap_uw_dhs_lsgkm/macs_files/UW.Fetal_Heart.ChromatinAccessibility.H-22662.DS12531_summits.bed	heart	fetal
../roadmap_uw_dhs_lsgkm/macs_files/UW.Fetal_Heart.ChromatinAccessibility.H-22727.DS12810_summits.bed	heart	fetal
../roadmap_uw_dhs_lsgkm/macs_files/UW.Fetal_Heart.ChromatinAccessibility.H-23468.DS15839_summits.bed	heart	fetal
../roadmap_uw_dhs_lsgkm/macs_files/UW.Fetal_Heart.ChromatinAccessibility.H-23500.DS16018_summits.bed	heart	fetal
../roadmap_uw_dhs_lsgkm/macs_files/UW.Fetal_Heart.ChromatinAccessibility.H-23524.DS16146_summits.bed	heart	fetal
../roadmap_uw_dhs_lsgkm/macs_files/UW.Fetal_Heart.ChromatinAccessibility.H-23589.DS16500_summits.bed	heart	fetal
../roadmap_uw_dhs_lsgkm/macs_files/UW.Fetal_Heart.ChromatinAccessibility.H-23604.DS16582_summits.bed	heart	fetal
../roadmap_uw_dhs_lsgkm/macs_files/UW.Fetal_Heart.ChromatinAccessibility.H-23617.DS16621_summits.bed	heart	fetal
../roadmap_uw_dhs_lsgkm/macs_files/UW.Fetal_Heart.ChromatinAccessibility.H-23663.DS16819_summits.bed	heart	fetal
../roadmap_uw_dhs_lsgkm/macs_files/UW.Fetal_Heart.ChromatinAccessibility.H-23744.DS19431_summits.bed	heart	fetal
../roadmap_uw_dhs_lsgkm/macs_files/UW.Fetal_Heart.ChromatinAccessibility.H-24042.DS19427_summits.bed	heart	fetal
